-18
20
-5
12
000000000000000000000000000000000000000
000111111111111111111111111111111111110
000100000000000000000000000000000000010
000100000000000000000000000000000000010
000100000000000000000000000000000000010
000100000000000000000000000000000000010
000100000000000000000000000000000000010
000100000000000000000000000000000000010
000100000000000000000000000000000000010
000100000000000000000000111111100000010
000100000000000000000000111111100000010
000100000000000000000000111111100000010
000100000000000000000000111111100000010
000100000000000000000001111111100000010
000100000000000000000001110001100000010
000100000000000000000000000000000000010
000100000000000000000000000000000000010
000111111111111111111111111111111111110
