0
13
-3
-3
00000000000000
00000011111110
00000011111110
00000011111110
00000011111110
00000111111110
00000111000110
00000000000000
